1111111111111
1E01000000C11
1000011111001
1P0C110000011
1111111111111