1111111111111111
1E0000001000C001
1010010100100101

1010011010010001
1P00000C00C000011
1111111111111111