111111111111
1E01000q0001
100C01111001
1P0C11E000E1
111111111111