1111111111111
1EE1000000C11
1000011111E01
1P00110000E11
1111111111111